1111111111111
100B0000000C1
1000011111001
1BP011CE00001
1111111111111